###........
#>#........
# #########
#         #
####.####<#
...#.#..###
...###.....
