###############################################
#<#...###.###...###...#.....#...#...#...#...#.#
#.#.#...#.....#.#.#.#.#.#.#.#.#.#.#.#.#.#.#.#.#
#...#.###.#####.#.#.#.#.#.#.#.#.#.#.#.#.#.#.#.#
#.#.#.#...#.#...#...#...#...#.#.#.#.#...#.#.#.#
#.#.#.###.#.###.#####.#####.###.#.#.###.#.#.#.#
#.#.#.....#.#...#.#...#.....#...#.#.#...#.#.#.#
#.#.#######.#.#.#.#.#.#.#####.#.#.#.#.#.#.#.#.#
#.#.........#.#.#.#.#.#.#.#...#.#.#...#.....#.#
#.###########.#.#.#.#.#.#.#.###.#.#########.#.#
#.#.........#...#...#.#...#.#...#.#.........#.#
#.#.#######.#######.#.#.###.#.###.#.#######.#.#
#.#.#.....#...#.....#.#...#...#...#...#...#.#.#
#.#.#.#####.#.#.#####.#.#.###########.#.#.#.#.#
#.#.#.#.....#.#...#...#.#.....#.....#.#.#...#.#
#.#.#.#.#####.#####.#.#######.#.###.#.#####.#.#
#.#.#.#...#...#.....#.#.....#.#.#...#.#.....#.#
#.#.#.###.#####.#####.#.###.#.#.#####.#.#####.#
#.#.#.....#.....#.....#.#...#.#...#...#.......#
#.#.#.#####.###.#.#####.###.#.###.#.#.#######.#
#...#.......#...#...#...#.#.#.....#.#.......#.#
#.#.###.#.#.#.#####.#.###.#.#.#.#.#.#######.#.#
#.#...#.#.#.#.....#.#.#...#.#.#.#...#.......#.#
#.#.###.#.#######.#.#.#.###.#.#.#.###########.#
#...#...#.........#...#...#.#.#.#.#>..........#
###############################################
